rows: 7 cols: 11
tiles:
###########
#S       ##
# ### ## ##
# ### ##E##
# ### ## ##
#        ##
###########
