rows: 7 cols: 16
tiles:
################
#S             #
# ### ###### # #
# ### ##E  #   #
# ### #### ##  #
#              #
################ 