rows: 9 cols: 22
tiles:
######################
#    # #         #   #
#    # #  E #### #   #
## ### ######  # # # #
#    #      #  # # # #
##  ## ## S ## # # ###
#  #    #            #
#       ######    #  #
######################
