rows: 7 cols: 19
tiles:
###################
#          #    # #
# ###  ##    ## # #
#  ##  # S #  # # #
##  #  #####  # # #
#E  #         #   #
###################
