rows: 10 cols: 8
tiles:
########
#     S#
# # ####
# #    #
# ######
#      #
###### #
# ##   #
#E#  # #
########
