rows:6 cols: 9
tiles:
#########
#    ## #
# ##S   #
#  ####E#
#       #
#########
